128,2,2,2,2,2,2,2,128,128
128,2,128,2,2,2,128,2,128,128
128,2,128,2,2,2,128,2,128,128
128,2,128,2,2,2,128,2,128,128
128,2,128,128,128,128,128,2,128,128
128,2,2,2,2,2,2,2,128,128
128,2,2,2,2,2,2,2,128,128
128,2,2,2,2,2,2,2,128,128
128,2,2,2,2,2,2,2,128,128