128,128,7,7,7,7,7,7,7,128
128,128,7,7,7,7,7,7,7,128
128,128,7,7,7,7,7,7,7,128
128,128,7,7,7,7,7,7,7,128
128,128,7,7,7,7,7,7,7,128
7,7,7,7,7,7,7,7,7,128
7,7,7,7,7,7,7,7,7,128
7,7,7,7,7,7,7,7,7,128
7,7,7,7,7,7,7,7,7,128
7,7,7,7,7,7,7,7,7,128
128,128,128,128,128,128,128,128,128,128